
                       C 111,      2,    2


F 220,100,     0  
NO ./sprites/stone.xpm
    WE   ./sprites/obsidian.xpm
         SO ./sprites/cobbelstone.xpm
       EA ./sprites/bookshelf.xpm

111111111111111111111111111111111111111111111111111111111111111111111111111111111111
111111111111111111111111111111111111111111111111111111111111111111111111111111111111
111111111111111111111111111111111111111111111111111111111111111111111111111111111111
111111111111111111111111111111111111110000000001111111111111111111111111111111111111
111111111111111111111111111111111111110000000001111111111111111111111111111111111111
111111111111111111111111111111111111110000000001111111111111111111111111111111111111
111111111111111111111111111111111111110000000001111111111111111111111111111111111111
111111111111111111111111111111111111110000000001111111111111111111111111111111111111
111111111111111111111111110001111111111011111111111111111111111111111111111111111111
111111111111111111111111110101111111111011111111111111111111111111111111111111111111
111111111111111111111111110101111111111011111111111111111111111111111111111111111111
1111111111111111111111111101011111111110111111111111111111111111111111111111111111111
11111111111111111111111111010111111111101111111111111111111111111111111111111111111
111111111111111111111111110101111111111011111111111111111111111111111111111111111111
111111111111111111111111110101111111111011111111111111111111111111111111111111111111
111111111111111111111111110000000011111000000001111111111111111111111111111111111111
111111111111111111111111110111111011111011111111111111111111111111111111111111111111
1111111111111111 1111111111111111011111011111111111111111111111111111111111111111111
111111111111111111111111110111111000000011111111111111111111111111111111111111111111
111111111111111111111111110111111111111111111111111111111111111111111111111111111111
111111111111111111111111110111111111111111111111111111111111111111111111111111111111
111111111111111111111111110111111111111111111111111111111111111111111111111111111111
111111111111000000000000000111111111111111111111111111111111111111111111111111111111
111111111111011111111111111111111111111111111111111111111111111111111111111111111111
111111111111011111111111111111111111111111111111111111111111111111111111111111111111
111111111111011111111111111111111111111111111111111111111111111111111111111111111111
111111111111011111111111111111111111111111111111111111111111111111111111111111111111
111111111111011111111111111111111111111111111111111111111111111111111111111111111111
111111111111011111111111111111111111111111111111111111111111111111111111111111111111
111111111111011111111111111111111111111111111111111111111111111111111111111111111111
111111111111011100000000011111111111111111111111111111111111111111111111111111111111
111111111111011101111111011111111111111111111111111111111111111111111111111111111111
111111111111011101111111011111111111111111111111111111111111111111111111111111111111
111111111111011101111111011111111111111111111111111111111111111111111111111111111111
111111111111011101111111011111111111111111111111111111111111111111111111111111111111
111111111111011101111111011111111111111111111111111111111111111111111111111111111111
111111111111011100000111011111111111111111111111111111111111111111111111111111111111
1111111111110111111100110111111111111111111111111111111111111111111111111111111111111
11111111111101111110011000000000000000001111111111111111111111111111111111111111111
111111111111011111110111111111111111111011111111111111111111111111111111111111111111
111111111111000000000111111111111111111011111111111111111111111111111111111111111111
111111111111111111111111111111111111111011111111111111111111111111111111111111111111
111111111111111111111111111111111111111011111111111111111111111111111111111111111111
111111111111111111111111111111111111111011111111111111111111111111111111111111111111
111111111111111111111111111111111111111000000000000111111111111111111111111111111111
111111111111111111111111111111111111111011111111110111111111111111111111111111111111
111111111111111111111111111111111111111011111111110111111111111111111111111111111111
111111111111111111111111111111111111111010000000000111111111111111111111111111111111
111111111111111111111111111111111111111N11111111111111111111111111111111111111111111
111111111111111111111111111111111111111111111111111111111111111111111111111111111111